NO /Users/amsbai/Desktop/cub/textures/wp13734161.png
WE /Users/amsbai/Desktop/cub/textures/pngegg.png
SO /Users/amsbai/Desktop/cub/textures/wp13734161.png
EA /Users/amsbai/Desktop/cub/textures/pngegg.png

F 69,47,36
C 152,214,213

        1111111111111111111111111
        1000000000110000000000001
    	1011000001110000000000001
    	1001000000000000010000001
111111111011000001110000000000001
100000000011000001110111111111111
11110111111111011100000010001
11110111111111011101010010001
11000000110101011100000010001
10000000000000001100000000001
10000000000000001101010010001
11000001110101011111011110N0111
11110111 1110101 101111010001
11111111 1111111 111111111111
